9
XXXXXXXXX
X.......X
X.X.X.S.X
X....XXXX
X...X..XX
XX......X
X..XFX..X
X.......X
XXXXXXXXX